hat: new Item(serverState.itemCatalogue, "a dashing topper", "head", 1)
crab: new Item(serverState.itemCatalogue, "chitin is tough", "head", 2)
leather-helm: new Item(serverState.itemCatalogue, "an olde football helmet", "head", 3)
fur-hat: new Item(serverState.itemCatalogue, "extremely warm", "head", 4)
hard-hat: new Item(serverState.itemCatalogue, "used in construction", "head", 5)
pot: new Item(serverState.itemCatalogue, "usually for sauces", "head", 8)
<: new Item(serverState.itemCatalogue, "for emoji", "head", 12)
steel-helm: new Item(serverState.itemCatalogue, "not good in a thunderstorm", "head", 18)
viking-helm: new Item(serverState.itemCatalogue, "with ram's horn technology", "head", 27)
spartan-helm: new Item(serverState.itemCatalogue, "plummage ftw", "head", 41)
crystal-helm: new Item(serverState.itemCatalogue, "extremely hard", "head", 62)
winged-helm: new Item(serverState.itemCatalogue, "does not grant flight", "head", 93)

sunglasses: new Item(serverState.itemCatalogue, "cheap, platic things", "eyes", 1)
monocole: new Item(serverState.itemCatalogue, "ready for the opera", "eyes", 2)
glasses: new Item(serverState.itemCatalogue, "glass lenses, metal frames", "eyes", 3)
goggles: new Item(serverState.itemCatalogue, "protects the eyes", "eyes", 5)
welding-goggles: new Item(serverState.itemCatalogue, "with smoked lenses", "eyes", 8)
B: new Item(serverState.itemCatalogue, "for emoji", "eyes", 12)
visor: new Item(serverState.itemCatalogue, "full eye protection", "eyes", 18)

towel: new Item(serverState.itemCatalogue, "number three of fourty two", "shoulders")
blanket: new Item(serverState.itemCatalogue, "a little better than a towel", "shoulders")
wool-coat: new Item(serverState.itemCatalogue, "very warm", "shoulders")
brown-cloak: new Item(serverState.itemCatalogue, "totally not a blanket you can wear all the time", "shoulders")
green-cloak: new Item(serverState.itemCatalogue, "feel one with nature", "shoulders")
red-cape: new Item(serverState.itemCatalogue, "vogue", "shoulders")
-: new Item(serverState.itemCatalogue, "for emoji", "shoulders")
fur-coat: new Item(serverState.itemCatalogue, "less fashion, more rugged", "shoulders")

pillow: new Item(serverState.itemCatalogue, "tie it around your chest", "torso", 1)
wood-slats: new Item(serverState.itemCatalogue, "WRAP it around your chest", "torso", 2)
leather-chest: new Item(serverState.itemCatalogue, "impact resistant", "torso", 4)
reflective-vest: new Item(serverState.itemCatalogue, "bright yellow", "torso", 5)
cookie-sheet: new Item(serverState.itemCatalogue, "kind of charred on the edge", "torso", 8)
#: new Item(serverState.itemCatalogue, "for emoji", "torso", 16)
chain-mail: new Item(serverState.itemCatalogue, "made of steel rings", "torso", 32)
kevlar: new Item(serverState.itemCatalogue, "incredible stopping power", "torso", 64)
imperial-breastplate: new Item(serverState.itemCatalogue, "adorned with prancing ponies", "torso", 128)

corse-pants: new Item(serverState.itemCatalogue, "made of sackclothe", "pants", 1)
slacks: new Item(serverState.itemCatalogue, "made of fine cotton", "pants", 2)
jeans: new Item(serverState.itemCatalogue, "sturdy work pants", "pants", 4)
leather-pants: new Item(serverState.itemCatalogue, "for rockstars", "pants", 8)
=: new Item(serverState.itemCatalogue, "for emoji", "pants", 16)
action-pants: new Item(serverState.itemCatalogue, "strong canvas pants with great mobility", "pants", 32)
speedo: new Item(serverState.itemCatalogue, "european-style swimsuit", "pants", 64)
silk-pants: new Item(serverState.itemCatalogue, "extremely elegant", "pants", 128)

rope: new Item(serverState.itemCatalogue, "holds up the pants", "belt")
braided-belt: new Item(serverState.itemCatalogue, "not very stylish", "belt")
leather-belt: new Item(serverState.itemCatalogue, "much more stylish", "belt")
work-belt: new Item(serverState.itemCatalogue, "could maybe hold tools", "belt")
utility-belt: new Item(serverState.itemCatalogue, "people might ask if your name is Bruce", "belt")

t-shirt: new Item(serverState.itemCatalogue, "reads \"whatever\"", "shirt")
hawaiian: new Item(serverState.itemCatalogue, "flower-print", "shirt")
dress-shirt: new Item(serverState.itemCatalogue, "made of fine cotton", "shirt")
flannel: new Item(serverState.itemCatalogue, "helps keep you warm", "shirt")
under-armor: new Item(serverState.itemCatalogue, "feel like a superhero", "shirt")
puffy-shirt: new Item(serverState.itemCatalogue, "feel like a PIRATE", "shirt")
leather-shirt: new Item(serverState.itemCatalogue, "for rockstars", "shirt")

sleeve: new Item(serverState.itemCatalogue, "cotton sleeve, to protect from minor cuts", "forearms", 1)
lobster-tail: new Item(serverState.itemCatalogue, "chitinous forearms", "forearms", 2)
magazines: new Item(serverState.itemCatalogue, "not pretty, but effective", "forearms", 4)
fur-bracer: new Item(serverState.itemCatalogue, "fairly decent protection, from cold and blows", "forearms", 8)
leather-bracer: new Item(serverState.itemCatalogue, "made from cow", "forearms", 16)
aluminum-sheet: new Item(serverState.itemCatalogue, "recovered from an airplane", "forearms", 32)
imperial-bracer: new Item(serverState.itemCatalogue, "grizzly bears etched into expertly crafted steel", "forearms", 64)

latex: new Item(serverState.itemCatalogue, "protects against chemicals", "gloves", 1)
leather-gloves: new Item(serverState.itemCatalogue, "warming, but pliable", "gloves", 2)
mittens: new Item(serverState.itemCatalogue, "very warm, but dexterity is lacking", "gloves", 4)
work-gloves: new Item(serverState.itemCatalogue, "basic leather gloves for working", "gloves", 8)
butcher-gloves: new Item(serverState.itemCatalogue, "protects against cuts", "gloves", 16)
gauntlet: new Item(serverState.itemCatalogue, "steel gloves of awesome", "gloves", 32)

shin-guards: new Item(serverState.itemCatalogue, "worn during certain sporting events", "shins", 1)
big-lobster-tail: new Item(serverState.itemCatalogue, "it is said that chitin promotes healing", "shins", 2)
catalogues: new Item(serverState.itemCatalogue, "kind of like magazines, but bigger", "shins", 4)
leather-shins: new Item(serverState.itemCatalogue, "good for deflecting kicks from todlers", "shins", 8)
split-muffler: new Item(serverState.itemCatalogue, "thin metal recovered from a vehicle", "shins", 16)
bronze-leggings: new Item(serverState.itemCatalogue, "made popular during the Roman Empire", "shins", 32)
steel-guards: new Item(serverState.itemCatalogue, "snakes adorn the front", "shins", 64)

chucks: new Item(serverState.itemCatalogue, "canvas shoes with a star logo on the side", "boots", 1)
dress-shoes: new Item(serverState.itemCatalogue, "leather-soled, snappy shoes", "boots", 2)
hiking-boots: new Item(serverState.itemCatalogue, "sturdy ankle support for mountainous treks", "boots", 4)
steel-toed: new Item(serverState.itemCatalogue, "used in construction", "boots", 8)
cowboy-boots: new Item(serverState.itemCatalogue, "made from alligator", "boots", 16)
steel-boots: new Item(serverState.itemCatalogue, "steel foot-gloves of awesome", "boots", 32)

needle: new Item(serverState.itemCatalogue, "can only balance two angels on the head", "tool", 1)
fishing-pole: new Item(serverState.itemCatalogue, "for teaching men to eat for a lifetime", "tool", 1)
screwdriver: new Item(serverState.itemCatalogue, "this particular one is not a drink", "tool", 2)
hammer: new Item(serverState.itemCatalogue, "for nails and skulls", "tool", 3)
handsaw: new Item(serverState.itemCatalogue, "many teeth, so many teeth", "tool", 3)
rusty-metal: new Item(serverState.itemCatalogue, "a rusty sword", "tool", 5)
shovel: new Item(serverState.itemCatalogue, "used to butter bread", "tool", 5)
pickaxe: new Item(serverState.itemCatalogue, "SMASH ROCK SMASH", "tool", 5)
butcher-knife: new Item(serverState.itemCatalogue, "cuts meat", "tool", 5)
hunting-knife: new Item(serverState.itemCatalogue, "used to butter bread", "tool", 7)
sword: new Item(serverState.itemCatalogue, "a basic sword", "tool", 10)
axe: new Item(serverState.itemCatalogue, "cuts wood", "tool", 15)
steel-sword: new Item(serverState.itemCatalogue, "it glistens in the sun", "tool", 20)
cutlas: new Item(serverState.itemCatalogue, "a curved blade for pirates", "tool", 40)
excalibur: new Item(serverState.itemCatalogue, "doesn't make you King Arthur", "tool", 80)
katana: new Item(serverState.itemCatalogue, "a great weapon for a great warrior", "tool", 150)

bird: new Item(serverState.itemCatalogue, "worth two in the shrubbery")
dead-bird: new Item(serverState.itemCatalogue, "maybe he's pining for the fjords?")
feather: new Item(serverState.itemCatalogue, "bird-hair")
rock: new Item(serverState.itemCatalogue, "definitely not a bird")
steel-wool: new Item(serverState.itemCatalogue, "very scratchy")
gold: new Item(serverState.itemCatalogue, "a yellow metal that seems to be highly valued in these realms")
log: new Item(serverState.itemCatalogue, "runs over your neighbors dog")
plank: new Item(serverState.itemCatalogue, "useful in construction")
ore: new Item(serverState.itemCatalogue, "dug from the earth")
coal: new Item(serverState.itemCatalogue, "also dug from the earth")
crucible: new Item(serverState.itemCatalogue, "a ceramic cup of sorts")
ingot: new Item(serverState.itemCatalogue, "it's like a brick, made of IRON")
emerald: new Item(serverState.itemCatalogue, "a very valuable jewel")
leather: new Item(serverState.itemCatalogue, "toughened skin of cow")
thread: new Item(serverState.itemCatalogue, "another name for string")
pie-plate: new Item(serverState.itemCatalogue, "for the creation of delectable treats")
bottle: new Item(serverState.itemCatalogue, "can hold liquids, or secrets")
herbs: new Item(serverState.itemCatalogue, "the buds of a special plant")

apple: new Item(serverState.itemCatalogue, "fruit", "food", 5)
peach: new Item(serverState.itemCatalogue, "fruit", "food", 5)
blueberries: new Item(serverState.itemCatalogue, "fruit", "food", 5)
small-potion: new Item(serverState.itemCatalogue, "recovers 10 health", "food", 10)
apple-pie: new Item(serverState.itemCatalogue, "quite yummy", "food", 20)
peach-pie: new Item(serverState.itemCatalogue, "quite yummy", "food", 20)
blueberry-pie: new Item(serverState.itemCatalogue, "quite yummy", "food", 20)
large-potion: new Item(serverState.itemCatalogue, "recovers 50 health", "food", 50)
